{
  "tanks": [
    {"x": 9, "y": 21},
    {"x": 9, "y": 29},
    {"x": 9, "y": 31},
    {"x": 11, "y": 21},
    {"x": 13, "y": 23},
    {"x": 21, "y": 21},
    {"x": 23, "y": 23},
    {"x": 11, "y": 31},
    {"x": 15, "y": 35},
    {"x": 15, "y": 37},
    {"x": 21, "y": 31},
    {"x": 31, "y": 31},
    {"x": 33, "y": 24}
  ],
  "helmets": [
    {"x": 70, "y": 40},
    {"x": 85, "y": 75}
  ]
}
