1 1 1 1 1 1 1 1 1 1 1 1 1 1 1 1 1 1 1 1 1 1 1 1 1 1 1 1 1 1 1 1 1 1 1 1 1 1 1 1 1 1 1 1 1 1 1 1 1 1
1 4 4 4 4 4 6 6 6 4 6 6 4 4 4 4 4 4 6 6 4 4 4 6 4 3 2 2 2 2 2 2 2 2 2 2 2 2 2 2 2 2 2 2 2 2 2 2 2 1
1 4 6 6 6 0 0 0 4 0 0 6 4 4 0 0 0 0 0 4 6 6 6 4 0 3 2 2 2 2 2 2 2 2 2 2 2 2 2 2 2 2 2 2 2 2 2 2 2 1
1 4 6 4 0 0 0 0 0 0 0 4 6 0 0 0 0 4 0 0 4 4 4 4 0 3 2 2 2 2 2 2 2 2 2 2 2 2 2 2 2 2 2 2 2 2 2 2 2 1
1 4 6 6 4 0 0 0 0 0 0 4 4 0 0 0 0 4 4 4 4 4 4 4 0 3 2 2 2 2 2 2 2 2 2 2 2 2 2 2 2 2 2 2 2 2 2 2 2 1
1 4 4 4 0 4 4 4 0 0 0 0 4 4 0 0 0 0 4 4 6 6 6 4 0 3 2 2 2 2 3 3 3 3 3 3 3 3 3 3 3 0 0 0 0 0 0 0 0 1
1 6 4 0 0 4 4 0 0 0 0 0 4 4 0 0 4 4 4 4 6 6 4 6 0 3 3 3 3 3 3 1 1 1 1 1 1 1 1 1 3 0 4 4 6 4 4 4 4 1
1 6 0 0 0 0 0 0 0 0 0 0 0 0 0 0 0 0 0 4 4 4 4 4 0 0 0 4 4 4 3 1 3 3 3 3 3 3 3 1 3 0 4 6 4 6 4 4 6 1
1 4 0 0 4 4 6 0 0 0 0 0 4 4 0 0 0 0 0 0 6 6 4 4 0 0 0 0 6 6 3 1 3 3 3 3 3 3 3 1 3 0 4 4 6 4 4 4 4 1
1 6 0 0 0 6 0 0 0 0 0 0 4 6 6 0 0 0 0 0 0 4 4 4 4 4 4 0 0 4 3 1 3 3 3 3 3 3 3 1 3 0 4 6 6 4 4 4 6 1
1 4 0 0 6 4 0 4 4 0 0 0 0 6 0 0 0 0 0 0 0 0 0 0 5 4 4 0 0 0 3 1 1 1 1 1 3 1 1 1 3 0 4 4 4 6 6 4 4 1
1 6 6 0 0 6 0 6 6 4 0 0 0 0 0 0 0 0 4 4 4 6 4 4 5 4 4 4 0 0 4 4 4 6 6 4 5 3 3 3 3 0 4 4 4 4 4 4 4 1
1 6 6 0 0 0 0 0 4 0 0 0 0 4 0 0 0 0 6 6 6 4 6 4 5 4 6 4 6 4 4 6 6 4 4 4 5 4 0 0 0 0 4 6 4 4 6 4 4 1
1 4 0 0 0 0 0 0 0 0 0 0 0 4 6 0 0 0 4 4 4 4 4 4 5 5 5 5 5 5 5 5 5 5 5 5 5 4 0 0 0 0 4 4 4 4 4 4 4 1
1 4 0 0 0 0 0 0 0 0 0 0 0 0 0 4 4 4 6 6 6 4 6 4 5 4 6 6 6 4 4 4 4 5 4 4 4 6 6 6 4 6 6 4 4 6 6 6 6 1
1 4 4 4 6 4 4 4 6 4 6 6 6 4 6 4 4 6 6 6 4 6 4 4 5 4 4 0 0 0 4 0 4 5 0 4 4 6 6 4 4 6 4 6 0 4 4 6 6 1
1 6 6 6 4 4 4 6 6 6 4 6 4 6 4 6 6 6 4 4 6 4 6 4 5 4 4 0 0 0 0 0 0 5 0 4 4 6 6 6 6 6 6 6 0 0 4 4 4 1
1 4 4 4 4 6 6 4 4 4 4 6 6 4 4 6 4 6 6 4 4 6 4 4 5 6 0 4 6 0 0 0 4 5 6 6 4 6 6 6 6 6 4 4 0 0 4 6 6 1
1 6 4 5 5 5 5 5 5 5 5 5 5 5 5 5 5 5 5 5 5 5 5 5 5 4 0 4 4 0 0 0 4 5 0 4 4 6 6 4 4 4 4 0 0 0 0 4 4 1
1 4 4 5 6 4 6 4 6 4 6 4 4 6 6 4 6 4 4 4 4 0 0 0 5 6 0 0 0 0 0 0 4 5 0 4 4 4 6 6 4 4 4 0 0 0 0 6 6 1
1 6 0 5 4 6 4 0 0 4 6 0 0 0 6 0 0 0 0 6 6 0 0 0 5 6 4 4 4 0 0 0 4 5 0 6 6 4 4 6 6 4 4 4 0 0 6 6 4 1
1 6 0 5 4 6 4 0 0 0 0 0 0 0 0 0 0 0 0 6 4 0 0 0 5 6 6 9 4 6 0 0 4 5 0 0 4 6 4 4 4 4 4 4 0 0 6 6 4 1
1 6 0 5 4 4 0 0 0 0 0 4 6 4 0 0 0 0 0 4 6 6 0 0 5 4 4 0 6 4 4 4 4 5 0 0 0 4 6 6 4 4 0 0 0 0 4 4 4 1
1 4 4 5 6 6 6 4 6 4 4 6 4 4 4 6 4 4 0 4 4 6 4 5 5 10 0 0 0 9 4 4 4 5 0 0 0 0 0 0 4 4 0 0 4 6 6 4 4 1
1 6 5 5 5 5 5 5 5 5 5 5 5 5 5 5 5 5 5 5 5 5 5 5 5 0 0 6 4 4 6 4 4 5 4 6 4 4 0 0 0 0 0 4 6 6 6 4 4 1
1 4 0 4 4 4 4 4 4 4 4 4 6 6 6 4 4 4 6 4 4 6 6 4 5 5 5 5 5 5 5 5 5 5 4 4 4 6 4 4 4 4 4 4 6 6 4 4 4 1
1 4 0 4 4 6 6 6 4 4 0 0 4 4 4 6 4 6 4 6 6 6 4 4 5 4 4 4 6 4 6 4 6 4 4 6 4 4 6 6 4 4 0 0 6 6 6 6 4 1
1 6 0 4 4 4 4 4 4 4 0 0 0 0 0 0 4 6 6 6 4 6 6 4 5 6 6 6 4 7 4 4 4 4 6 6 4 4 0 0 0 0 0 0 4 6 6 4 6 1
1 4 0 4 4 4 4 4 4 0 0 4 4 4 4 0 0 4 6 6 6 4 4 4 5 4 6 4 4 0 4 0 0 4 6 4 6 4 0 0 0 4 0 0 4 4 6 6 4 1
1 4 0 0 0 4 6 6 6 0 0 0 0 6 4 0 0 0 0 0 0 0 4 4 5 4 4 4 4 0 0 0 0 4 6 4 0 0 0 0 4 4 4 6 6 4 4 4 4 1
1 6 4 4 0 4 4 6 4 0 0 0 0 4 4 4 0 4 4 4 4 4 4 4 5 6 6 6 4 4 4 0 0 0 0 0 0 0 0 0 0 0 0 0 0 0 0 0 0 1
1 4 4 6 0 4 4 4 4 0 0 0 0 4 6 6 0 4 0 0 0 0 4 4 5 4 4 4 0 6 0 0 0 4 4 0 0 0 0 0 0 0 0 0 4 4 4 0 0 1
1 6 4 4 0 4 4 0 0 0 0 4 4 4 4 4 0 0 0 0 0 0 4 4 5 4 4 4 0 0 0 0 0 4 4 4 0 0 0 4 6 5 0 0 4 4 4 0 0 1
1 6 6 6 0 0 0 0 0 0 4 4 4 6 4 4 6 4 4 0 0 6 6 4 5 4 6 4 4 4 4 4 0 0 0 0 0 0 0 4 4 5 0 0 0 0 0 0 0 1
1 4 4 4 0 4 4 6 4 4 6 6 6 6 4 6 4 4 6 4 6 6 4 4 5 4 4 4 6 4 6 6 4 6 0 0 0 0 0 4 4 5 4 4 6 6 6 6 4 1
1 6 4 4 0 4 6 6 6 4 4 6 6 4 4 6 4 4 4 4 6 6 4 4 5 4 4 6 4 4 6 4 4 4 6 4 6 4 4 6 4 5 6 4 6 6 4 4 4 1
1 4 6 4 0 4 4 6 4 6 6 6 4 6 6 4 4 5 5 5 5 5 5 5 5 5 5 5 5 5 5 5 5 5 5 5 5 5 5 5 5 5 5 5 5 5 5 5 4 1
1 4 6 4 0 4 4 4 6 6 4 6 4 4 6 4 4 5 4 4 4 6 6 4 5 4 6 6 6 4 4 4 4 6 4 4 6 6 6 4 4 4 6 4 4 4 4 5 6 1
1 6 4 4 0 6 6 6 4 6 4 4 4 4 4 6 4 5 4 6 6 6 4 4 5 4 4 4 4 4 6 6 6 4 4 4 4 4 4 4 4 6 6 4 6 4 4 5 4 1
1 0 0 0 0 0 0 0 0 0 0 0 0 0 0 0 0 0 4 4 6 4 4 4 5 4 6 6 6 4 4 5 5 5 5 5 5 5 5 5 5 5 5 5 5 5 5 5 4 1
1 0 8 8 8 0 8 8 8 0 8 0 8 0 0 0 0 6 6 6 4 6 4 4 5 4 4 6 4 4 4 0 4 4 4 6 6 4 4 4 6 6 4 4 4 4 4 4 4 1
1 0 8 0 8 0 0 8 0 0 8 0 8 0 0 0 0 4 4 0 4 6 6 4 5 4 6 6 6 4 4 0 4 4 6 6 6 6 4 4 4 4 6 6 4 4 6 6 4 1
1 0 8 8 8 0 0 8 0 0 8 0 8 0 0 0 0 0 4 0 0 4 4 4 5 4 4 4 6 4 4 0 4 4 4 4 4 6 6 4 4 6 6 4 4 6 6 4 4 1
1 0 8 0 0 0 0 8 0 0 8 8 0 0 0 0 0 0 0 0 0 0 4 4 5 4 6 0 0 0 0 0 0 0 0 0 0 0 0 0 0 0 0 0 0 0 0 0 0 1
1 0 8 0 0 0 8 8 0 0 8 0 0 0 0 0 6 6 0 0 0 4 4 6 5 4 4 0 0 0 8 0 8 0 8 8 8 0 8 8 8 0 8 8 8 0 8 8 8 1
1 0 0 0 0 0 0 0 0 0 0 0 0 0 6 4 6 6 4 0 4 4 6 4 5 4 4 0 0 0 8 0 8 0 8 0 8 0 8 0 8 0 8 0 0 0 8 0 0 1
1 4 0 4 6 6 6 4 4 6 6 4 4 6 4 4 4 6 6 4 4 6 4 6 5 4 0 0 0 0 8 8 0 0 8 8 0 0 8 0 8 0 8 8 8 0 8 8 8 1
1 4 5 5 5 5 5 5 5 5 5 5 5 5 5 5 5 5 4 4 4 6 4 4 5 4 0 0 0 0 8 0 8 0 8 0 8 0 8 0 8 0 0 0 8 0 0 0 8 1
1 4 4 4 4 4 6 6 4 6 6 4 4 6 6 6 4 5 5 5 5 5 5 5 5 0 0 4 4 4 8 0 8 0 8 0 8 0 8 8 8 0 8 8 8 0 8 8 8 1
1 1 1 1 1 1 1 1 1 1 1 1 1 1 1 1 1 1 1 1 1 1 1 1 1 1 1 1 1 1 1 1 1 1 1 1 1 1 1 1 1 1 1 1 1 1 1 1 1 1