1 1 1 1 1 1 1 1 1 1 1 1 1 1 1 1 1 1 1 1 1 1 1 1 1 1 1 1 1 1 1 1 1 1 1 1 1 1 1 1 1 1 1 1 1 1 1 1 1 1
1 2 2 2 2 2 2 2 2 2 2 2 2 2 2 2 2 2 2 2 2 2 2 2 2 2 2 2 2 2 2 2 2 2 2 2 2 2 2 2 2 2 2 2 2 2 2 2 2 1
1 2 2 2 2 2 2 2 2 2 2 2 2 2 2 2 2 2 2 2 2 2 2 2 2 2 2 2 2 2 2 2 2 2 2 2 2 2 2 2 2 2 2 2 2 2 2 2 2 1
1 2 2 2 2 2 2 2 2 2 2 2 2 2 2 2 2 2 2 2 2 2 2 2 2 2 2 2 2 2 2 2 2 2 2 2 2 2 2 2 2 2 2 2 2 2 2 2 2 1
1 2 2 0 0 0 0 0 0 2 2 2 4 6 6 2 2 2 4 6 2 2 2 4 6 6 2 2 2 2 6 4 4 6 4 4 4 6 6 6 4 6 6 2 2 2 2 2 2 1
1 2 2 0 0 8 8 8 0 6 4 6 6 4 6 6 4 6 4 4 6 4 6 4 4 4 6 6 4 4 6 4 6 6 4 6 4 6 4 6 4 6 6 0 0 0 2 2 2 1
1 2 2 0 0 8 0 0 0 6 5 0 0 0 0 0 0 0 0 12 6 6 0 0 0 0 0 0 0 0 3 1 1 1 1 1 1 1 1 3 4 0 4 4 6 4 2 2 2 1
1 2 2 0 0 8 8 8 0 4 5 4 0 0 0 0 0 0 0 0 4 4 0 0 0 0 0 4 4 4 3 1 3 3 3 3 3 3 1 3 6 6 0 0 0 0 0 2 2 1
1 2 2 0 0 8 0 0 0 6 5 6 0 4 0 0 0 0 0 0 6 6 0 0 0 0 0 0 6 6 3 1 3 3 3 3 3 3 1 3 4 6 0 0 0 0 0 2 2 1
1 2 2 0 0 8 0 0 0 4 5 4 0 6 6 4 4 6 6 0 0 4 6 4 6 4 4 0 0 4 3 1 3 3 3 3 3 3 1 3 6 4 0 0 0 0 0 2 2 1
1 2 2 0 0 0 0 0 0 6 5 6 0 6 0 0 0 0 4 0 0 0 0 0 5 4 4 0 0 0 3 1 1 1 1 1 3 1 1 3 4 4 0 0 0 0 0 2 2 1
1 2 2 0 0 8 8 8 0 6 5 6 0 4 0 4 4 0 6 0 0 0 4 4 5 4 4 4 0 0 3 3 3 3 3 3 3 3 3 3 6 0 0 0 0 0 0 2 2 1
1 2 2 0 0 8 0 0 0 6 5 6 0 0 0 4 4 0 4 0 6 4 6 4 5 4 6 4 6 4 4 6 6 4 4 4 6 4 6 5 4 0 0 0 0 0 0 2 2 1
1 2 2 0 0 8 8 8 0 6 5 4 4 4 6 6 6 4 4 4 4 4 4 4 5 5 5 5 5 5 5 5 5 5 5 5 5 5 5 5 6 0 0 0 0 0 0 2 2 1
1 2 2 0 0 8 0 0 0 6 5 5 5 5 5 5 5 5 5 5 5 5 5 5 5 4 6 6 4 6 6 4 6 4 6 6 6 4 6 6 4 0 0 8 0 8 0 2 2 1
1 2 2 0 0 8 8 8 0 6 6 6 6 4 6 4 4 6 6 6 4 6 4 4 5 4 4 0 0 0 4 0 0 0 0 4 4 6 0 0 6 0 0 8 0 8 0 2 2 1     
1 2 2 0 0 0 0 0 0 6 4 4 0 0 0 0 0 0 0 0 0 0 0 0 5 0 0 0 0 0 0 0 0 0 0 0 0 0 0 0 4 0 0 8 8 0 0 2 2 1
1 2 2 0 0 8 0 0 0 4 0 0 0 4 0 6 4 0 0 0 0 0 0 6 5 6 0 0 0 0 0 0 0 0 6 6 0 0 0 0 6 0 0 8 0 8 0 2 2 1
1 2 2 0 0 8 0 0 0 6 0 0 4 6 0 6 0 6 4 6 0 0 0 4 5 6 0 0 0 0 0 4 4 0 0 4 0 6 6 4 6 0 0 8 0 8 0 2 2 1
1 2 2 0 0 8 0 0 0 4 0 0 0 0 0 0 0 0 0 0 0 0 6 6 5 4 0 0 0 0 0 0 0 0 0 0 0 0 0 4 4 0 0 0 0 0 0 2 2 1
1 2 2 0 0 8 0 0 0 6 0 0 0 6 6 0 0 0 4 4 6 6 6 4 5 6 4 4 0 0 0 0 6 0 0 0 6 4 0 4 6 0 0 8 8 8 0 2 2 1
1 2 2 0 0 8 8 8 0 6 4 0 0 6 0 0 0 0 0 0 0 0 0 0 5 6 6 9 4 6 0 0 0 0 0 0 4 6 0 6 6 0 0 8 0 8 0 2 2 1
1 2 2 0 0 0 0 0 0 6 6 0 6 4 0 0 0 0 0 4 0 0 0 0 5 4 4 0 6 4 4 6 0 0 0 0 0 4 6 4 4 0 0 8 8 0 0 2 2 1
1 2 2 0 0 0 0 0 0 4 0 0 4 0 0 0 0 0 0 4 6 4 0 0 5 10 0 0 0 9 4 6 0 0 0 0 0 0 6 6 6 0 0 8 0 8 0 2 2 1
1 2 2 0 0 8 8 8 0 6 0 0 0 0 0 0 0 0 0 0 0 0 0 0 5 0 0 0 0 0 0 0 0 4 4 6 4 6 6 4 4 0 0 8 0 8 0 2 2 1
1 2 2 0 0 8 0 0 0 6 0 4 0 0 0 0 0 0 0 0 0 0 0 4 5 5 5 5 5 5 5 5 5 5 5 5 5 5 5 5 6 0 0 0 0 0 0 2 2 1
1 2 2 0 0 8 0 0 0 4 0 4 0 0 0 0 0 0 0 6 0 0 0 6 5 0 0 4 6 0 6 4 6 4 4 6 4 4 6 5 6 0 0 8 8 8 0 2 2 1
1 2 2 0 0 8 8 8 0 6 0 6 0 0 0 6 4 0 0 6 4 6 0 4 5 6 6 6 4 7 4 4 4 4 6 0 0 0 6 5 4 0 0 8 0 8 0 2 2 1
1 2 2 0 0 0 0 0 0 4 0 4 0 6 4 4 6 0 0 0 6 6 0 0 5 6 0 0 0 0 0 0 0 0 0 0 0 0 0 5 4 0 0 8 0 8 0 2 2 1
1 2 2 0 0 8 0 8 0 6 0 0 0 0 4 0 0 0 0 0 6 4 0 4 5 4 0 0 0 0 6 6 0 0 0 0 0 0 4 5 6 0 0 8 0 8 0 2 2 1
1 2 2 0 0 8 0 8 0 6 0 0 0 0 6 0 0 0 0 0 0 0 0 0 5 6 6 4 0 0 4 0 0 0 0 0 0 0 6 5 6 0 0 8 8 8 0 2 2 1
1 2 2 0 0 8 0 8 0 6 0 4 4 4 6 0 0 0 4 4 0 0 4 4 5 4 4 6 6 0 0 0 0 4 6 0 0 6 4 5 4 0 0 0 0 0 0 2 2 1
1 2 2 0 0 0 8 0 0 6 0 0 0 0 6 0 0 0 0 0 0 0 0 4 5 4 4 4 6 6 4 0 6 4 4 6 4 6 4 5 6 0 0 8 8 8 0 2 2 1
1 2 2 0 0 0 0 0 0 6 6 4 4 4 6 4 4 6 4 4 6 4 4 6 5 5 5 5 5 5 5 5 5 5 5 5 5 5 5 5 4 0 0 8 0 0 0 2 2 1
1 2 2 0 0 8 0 8 0 6 2 2 2 2 2 2 2 2 2 2 2 2 2 2 5 6 6 6 4 6 4 4 6 0 4 4 6 4 6 5 6 0 0 8 8 8 0 2 2 1
1 2 2 0 0 8 0 8 0 4 2 2 2 2 2 2 2 2 2 2 2 2 2 2 5 4 0 0 4 0 6 4 0 0 6 4 6 4 4 5 6 0 0 0 0 8 0 2 2 1
1 2 2 0 0 8 0 8 0 6 2 4 4 6 4 6 6 4 6 4 4 4 2 2 5 6 0 0 0 0 4 0 0 4 6 0 0 4 6 5 4 0 0 8 8 8 0 2 2 1
1 2 2 0 0 8 8 8 0 4 2 4 0 0 0 0 0 0 0 0 0 6 2 2 5 4 0 0 0 0 0 0 0 6 4 0 0 6 6 5 6 0 0 0 0 0 0 2 2 1
1 2 2 0 0 0 0 0 0 6 2 6 0 6 4 0 0 4 6 4 6 4 2 2 5 6 0 0 0 0 0 0 0 0 0 0 0 0 4 5 4 0 0 8 8 8 0 2 2 1
1 2 2 0 0 8 8 8 0 4 2 4 0 4 6 0 0 0 0 0 0 4 2 2 5 6 0 0 4 6 0 0 0 6 6 0 6 0 6 5 6 0 0 8 0 0 0 2 2 1
1 2 2 0 0 0 8 0 0 6 2 6 0 6 6 0 4 0 0 0 0 6 2 2 5 4 0 0 0 4 0 0 0 0 0 0 6 0 4 5 6 0 0 8 8 8 0 2 2 1
1 2 2 0 0 0 8 0 0 4 2 6 0 0 0 0 6 0 6 4 4 6 2 2 5 4 6 0 0 0 0 0 0 4 0 0 0 0 4 5 4 0 0 0 0 8 0 2 2 1
1 2 2 0 0 0 8 0 0 6 2 4 0 0 6 4 6 0 0 0 7 4 2 2 5 4 4 4 6 4 4 0 4 6 4 6 4 6 6 5 6 0 0 8 8 8 0 2 2 1
1 2 2 0 0 0 0 0 0 6 2 6 6 4 4 6 4 4 4 6 4 4 2 2 5 5 5 5 5 5 5 5 5 5 5 5 5 5 5 5 6 0 0 0 0 0 0 2 2 1
1 2 2 2 2 2 2 2 2 2 2 2 2 2 2 2 2 2 2 2 2 2 2 2 2 2 2 2 2 2 2 2 2 2 2 2 2 2 2 2 2 2 2 2 2 2 2 2 2 1
1 2 2 2 2 2 2 2 2 2 2 2 2 2 2 2 2 2 2 2 2 2 2 2 2 2 2 2 2 2 2 2 2 2 2 2 2 2 2 2 2 2 2 2 2 2 2 2 2 1
1 2 2 2 2 2 2 2 2 2 2 2 2 2 2 2 2 2 2 2 2 2 2 2 2 2 2 2 2 2 2 2 2 2 2 2 2 2 2 2 2 2 2 2 2 2 2 2 2 1
1 2 2 2 2 2 2 2 2 2 2 2 2 2 2 2 2 2 2 2 2 2 2 2 2 2 2 2 2 2 2 2 2 2 2 2 2 2 2 2 2 2 2 2 2 2 2 2 2 1
1 2 2 2 2 2 2 2 2 2 2 2 2 2 2 2 2 2 2 2 2 2 2 2 2 2 2 2 2 2 2 2 2 2 2 2 2 2 2 2 2 2 2 2 2 2 2 2 2 1
1 1 1 1 1 1 1 1 1 1 1 1 1 1 1 1 1 1 1 1 1 1 1 1 1 1 1 1 1 1 1 1 1 1 1 1 1 1 1 1 1 1 1 1 1 1 1 1 1 1